##########
#........#
#........#
#...p....#
#........#
#........#
#........#
#........#
#........#
##########